xdg-open=Open File Manager
mousepad=Open Text Editor
marker=Open Markdown Text Editor
/opt/lampp/lampp start=Start Xampp Server
vi=Open Vi (No Arrows)
vim=Open Vi improved
lsof -ti tcp:8000=Find process using port 8000
nethogs=Monitor network
open=Open a project
systemctl restart NetworkManager=Restart Network Manger
systemctl start systemd-homed=Start Home Manager
shuf=Shuffle lines of a File
/opt/lampp/bin/mysql -u root=Open MySQL CLI
hostname -I=Shows current Ip
hexdump=Shows file content in different formats
xxd -p=Shows file content as hex
xxd -p -r=Returns file from hex
echo '0a68..' | xxd -p -r > file=Creates file with bytes as content
rclone mount --daemon gdrive: ~/gdrive=Mount my Google Drive Account
df=Shows information about file system
sudo umount gdrive:=Unmounts Google Drive Account
mimeopen -d file=Changes the default application reader
faillock --user username --reset=Resets attempts lock
rsync --progress src dest=Copies src to dest with progress
setxkbmap fr=Sets Keyboard layout to fr
binwalk --signature --term file.bin=Reverse engineer binary
strings file.bin=Display printable strings in binary
glances=Show full System Monitor
mount image.iso /media/iso -o loop=Mounts ISO
task=Open Tasks List
systemctl restart sshd.service=Restart SSH Service
archlinux-java=Change Java Version
systemctl start elasticsearch.service=Start Elasticsearch
systemctl start kafka.service=Start Kafka
systemctl start  redis.service=Start Redis
systemctl start docker=Start Docker
curl portquiz.net:80=Test if port 80 is open
nordvpn set protocol TCP=Change Nordvpn into TCP mode
bluetoothctl=Start bluetooth utility
info=Generic info for command
nmcli device wifi show=Show Wifi Info
